00000000000000000000-
00220000000000000000-
00200000000000000000-
00000000000000000000-
00000000000000000000-
00000000000000000000-
00000000000000000000-
00000000000000000000-
00000000000000000000-
00000000000000000000-
00000000000000000000-
00000000000000000000-
00000000000000000000-
00000000000000000000-
00000000000000000000-
00000000000000000000-
00000000000000000000-
00000000000000000000-
00000000000000000000-
00000000000000000000