01000000000000000000-
01000000000000000000-
00000000000000000000-
00000000000200000000-
00000000002000000000-
00000000020000000000-
00000000000000000000-
00000000020000000000-
00000000000000000000-
00000000020000000000-
00000000000000000000-
00000000020000000000-
00000000000000000000-
00000000000000000000-
00000000000000000000-
00000000000000000000-
00000000000000000000-
00000000000000000000-
00000000000000000000-
00000000000000000000