00000000000000000000000000000000000000000000000000-
00000000000000000000000000000000000000000000000000-
00000000000000000000000000000000000000000000000000-
00000000000000000000000000000000000000000000000000-
00000000000000000000000022220000000000000000000000-
00000000000000000000000022220000000000000000000000-
00000000000000000000000022220000000000000000000000-
00000000000000000000000022220000000000000000000000-
00000000000000000000000022220000000000000000000000-
00000000000000000000000022220000000000000000000000-
00000000000000000000000322220000000000000000000000-
00000000000000000000003322220000000000000000000000-
00000000000000000000033222220000000000000000000000-
00000000000000000000330222220000000000000000000000-
00000000000000000003300222220000000000000000000000-
00000000000000000033000222220000000000000000000000-
00000000000000000330000000000000000000000000000000-
00000000000000003300000000000000000000000000000000-
00000000000000033000000000000000000000000000000000-
00000000000000330000000000000000000000000000000000-
00000000000003300000000000000000000000000000000000-
00000000000033000000000000000000000000000000000000-
00000000000330000000000000000000000000000000000000-
00000000000000000000000000000000000000000000000000-
00000000000000000000000000000000000000000000000000-
00000000000000000000000000000000000000000000000000-
00000000000000000000000000000000000000000000000000-
00000000000000000000000000000000000000000000000000-
00000000000000000000000000000000000000000000000000-
00000000000000000000000000000000000000000000000000-
00000000000000000000000000000000000000000000000000-
00000000000000000000000000000000000000000000000000-
00000000000000000000000000000000000000000000000000-
00000000000000000000000000000000000000000000000000-
00000000000000000000000000000000000000000000000000-
00000000000000000000000000000000000000000000000000-
00000000000000000000000000000000000000000000000000-
00000000000000000000000000000000000000000000000000-
00000000000000000000000000000000000000000000000000-
00000000000000000000000000000000000000000000000000-
00000000000000000000000000000000000000000000000000-
00000000000000000000000000000000000000000000000000-
00000000000000000000000000000000000000000000000000-
00000000000000000000000000000000000000000000000000-
00000000000000000000000000000000000000000000000000-
00000000000000000000000000000000000000000000000000-
00000000000000000000000000000000000000000000000000-
00000000000000000000000000000000000000000000000000-
00000000000000000000000000000000000000000000000000-
00000000000000000000000000000000000000000000000000