00000000000000000000-
00000000000000000000-
00000000000000000000-
00000000000000000000-
00000000000300000000-
00000223333100000000-
00000223333100000000-
00000000000000000000-
00000000000000000000-
00000000000000000000-
00000000300000000000-
00000000000000000000-
00000000000000000000-
00000000000000000000-
00000000000000000000-
00000000000000000000-
00000000000000000000-
00000000000000000000-
00000000000000000000-
00000000000000000000